nettle                         Nettle - Nettle low-level cryptographic library (symmetric algorithms)
libcryptsetup                  cryptsetup - cryptsetup library
readline                       Readline - Gnu Readline library for command line editing
ini_config                     ini_config - Library to process config files in INI format into a libcollection data structure
libbrotlidec                   libbrotlidec - Brotli decoder library
ncurses++                      ncurses++w - ncurses 6.4 add-on library
libcrypto                      OpenSSL-libcrypto - OpenSSL cryptography library
kadm-client                    kadm-client - Kerberos administration client library
tss2-rc                        tss2-rc - TPM2 error decoding library.
libalpm                        libalpm - Arch Linux package management library
gnutls                         GnuTLS - Transport Security Layer implementation for the GNU system
libnftables                    libnftables - Netfilter nf_tables user library
ref_array                      ref_array - A dynamically-growing, reference-counted array
bluez                          BlueZ - Bluetooth protocol stack for Linux
libparted                      libparted - The GNU Parted disk partitioning shared library
libnewt                        libnewt - A development library for text mode user interfaces
libffi                         libffi - Library supporting Foreign Function Interfaces
basicobjects                   basicobjects - Library contains basic objects like dynamic string
auparse                        libauparse - Library for apps that want to parse and interpret audit events
openssl                        OpenSSL - Secure Sockets Layer and cryptography libraries and tools
libnetfilter_conntrack         libnetfilter_conntrack - netfilter userspace conntrack access library
icu-uc                         icu-uc - International Components for Unicode: Common and Data libraries
efivar                         efivar - UEFI Variable Management
libpcre2-16                    libpcre2-16 - PCRE2 - Perl compatible regular expressions C library (2nd API) with 16 bit character support
libedit                        libedit - command line editor library provides generic line editing, history, and tokenization functions.
tss2-tctildr                   tss2-tctildr - Library to simplify management of TCTIs.
libzstd                        zstd - fast lossless compression algorithm library
ldns                           ldns - Library for DNS programming
libdw                          libdw - elfutils library for DWARF data and ELF file or process inspection
libpcre16                      libpcre16 - PCRE - Perl compatible regular expressions C library with 16 bit character support
libelf                         libelf - elfutils libelf library to read and write ELF files
isl                            isl - isl Library
bash                           bash - Bash headers for bash loadable builtins
libpcre2-posix                 libpcre2-posix - Posix compatible interface to libpcre2-8
libattr                        libattr - A library for filesystem extended attribute support
gpg-error                      gpg-error - GPG Runtime
python-3.11-embed              Python - Embed Python into an application
libseccomp                     libseccomp - The enhanced seccomp library
gmp                            GNU MP - GNU Multiple Precision Arithmetic Library
tss2-policy                    tss2-policy - TPM2 policy library.
tss2-tcti-cmd                  tss2-tcti-cmd - TCTI library for communicating with a subproccess that can communicate with the TPM.
ss                             ss - Subsystem command parsing library
libsecret-unstable             libsecret-unstable - GObject bindings for Secret Service API (Unstable)
jemalloc                       jemalloc - A general purpose malloc(3) implementation that emphasizes fragmentation avoidance and scalable concurrency support.
libpcre                        libpcre - PCRE - Perl compatible regular expressions C library with 8 bit character support
libbrotlicommon                libbrotlicommon - Brotli common dictionary library
libsodium                      libsodium - A modern and easy-to-use crypto library
efiboot                        efiboot - UEFI Boot variable support
libsystemd                     systemd - systemd Library
python3                        Python - Build a C extension for Python
liburing                       liburing - io_uring library
libgcrypt                      libgcrypt - General purpose cryptographic library
lmdb                           liblmdb - Lightning Memory-Mapped Database
libxml-2.0                     libXML - libXML library version2.
libbrotlienc                   libbrotlienc - Brotli encoder library
history                        History - Gnu History library for managing previously-entered lines
gio-2.0                        GIO - glib I/O library
pam                            PAM - The primary Linux-PAM library. It is used by PAM modules and PAM-aware applications.
json-c                         json-c - A JSON implementation in C
gmodule-export-2.0             GModule - Dynamic module loader for GLib
uuid                           uuid - Universally unique id library
libtirpc                       libtirpc - Transport Independent RPC Library
tss2-fapi                      tss2-fapi - TPM2 Feature API library.
yaml-0.1                       LibYAML - Library to parse and emit YAML
libidn2                        libidn2 - Library implementing IDNA2008 and TR46
gpgme                          gpgme - GnuPG Made Easy to access GnuPG
duktape                        duktape - Embeddable Javascript engine
libip4tc                       libip4tc - iptables IPv4 ruleset ADT and kernel interface
ext2fs                         ext2fs - Ext2fs library
nss                            NSS - Network Security Services
gobject-2.0                    GObject - GLib Type, Object, Parameter and Signal Library
krb5                           krb5 - An implementation of Kerberos network authentication
libdaemon                      libdaemon - a lightweight C library that eases the writing of UNIX daemons
xtables                        xtables - Shared Xtables code for extensions and iproute2
panel                          panelw - ncurses 6.4 add-on library
tss2-tcti-libtpms              tss2-tcti-libtpms - TCTI library for communicating with the libtpms library.
zlib                           zlib - zlib compression library
glib-2.0                       GLib - C Utility Library
jansson                        Jansson - Library for encoding, decoding and manipulating JSON data
mit-krb5-gssapi                mit-krb5-gssapi - Kerberos implementation of the GSSAPI
ldap                           ldap (OpenLDAP) - OpenLDAP Lightweight Directory Access Protocol library
p11-kit-1                      p11-kit - Library and proxy module for properly loading and sharing PKCS
audit                          libaudit - Libraries needed for apps that use the kernel audit framework
bdw-gc                         Boehm-Demers-Weiser Conservative Garbage Collector - A garbage collector for C and C++
ncursesw                       ncursesw - ncurses 6.4 library
tss2-tcti-device               tss2-tcti-device - TCTI library for communicating with a TPM device node.
libverto-libevent              libverto-libevent - Event loop abstraction interface (libevent module)
kdb                            kdb - Kerberos database access libraries
gmodule-no-export-2.0          GModule - Dynamic module loader for GLib
libip6tc                       libip6tc - iptables IPv6 ruleset ADT and kernel interface
blkid                          blkid - Block device id library
libnl-3.0                      libnl - Convenience library for netlink sockets
tss2-tcti-spi-helper           tss2-tcti-spi-helper - TCTI library for communicating with the TPM over SPI.
panelw                         panelw - ncurses 6.4 add-on library
slang                          slang - S-Lang programming library and interpreter
libpsl                         libpsl - Public Suffix List C library.
popt                           popt - popt library.
libmaxminddb                   libmaxminddb - C library for the MaxMind DB file format
libtasn1                       libtasn1 - Library for ASN.1 and DER manipulation
libpci                         libpci - libpci
kadm-server                    kadm-server - Kerberos administration server library
oniguruma                      oniguruma - Regular expression library
tss2-tcti-pcap                 tss2-tcti-pcap - TCTI library for debugging at the TCTI interface.
krb5-gssapi                    krb5-gssapi - Kerberos implementation of the GSSAPI
devmapper                      devmapper - device-mapper library
libjq                          libjq - Library to process JSON using a query language
libpkgconf                     libpkgconf - a library for accessing and manipulating development framework configuration
libsecret-1                    libsecret-1 - GObject bindings for Secret Service API
libnm                          libnm - Convenience library for clients of NetworkManager
e2p                            e2p - Ext2fs userspace programs utility library
libndp                         libndp - Neighbour discovery library.
tss2-tcti-mssim                tss2-tcti-mssim - TCTI library for communicating with the Microsoft TPM2 simulator.
menuw                          menuw - ncurses 6.4 add-on library
ncurses                        ncursesw - ncurses 6.4 library
libnl-idiag-3.0                libnl-idiag - Netlink Inet Diag Family Library
dhash                          dhash - A hash table which will dynamically resize to achieve optimal storage & access time properties
libacl                         libacl - A library for POSIX Access Control Lists
libdebuginfod                  debuginfod - elfutils library to query debuginfo files from debuginfod servers
gssrpc                         gssrpc - GSSAPI RPC implementation
libevent_openssl               libevent_openssl - libevent_openssl adds openssl-based TLS support to libevent
python-3.11                    Python - Build a C extension for Python
libarchive                     libarchive - library that can create and read several streaming archive formats
libmagic                       libmagic - Magic number recognition library
libnsl                         libnsl - Library containing NIS functions using TI-RPC (IPv6 enabled)
pamc                           libpamc - The PAM client API library and binary prompt support. Rarely used.
gio-unix-2.0                   GIO unix specific APIs - unix specific headers for glib I/O library
libzmq                         libzmq - 0MQ c++ library
libssh2                        libssh2 - Library for SSH-based communication
fuse3                          fuse3 - Filesystem in Userspace
libproc2                       libproc2 - Library to control and query process state
libuv                          libuv - multi-platform support library with a focus on asynchronous I/O.
devmapper-event                devmapper-event - device-mapper event library
libpcre2-8                     libpcre2-8 - PCRE2 - Perl compatible regular expressions C library (2nd API) with 8 bit character support
libevent_extra                 libevent_extra - libevent_extra
libteamdctl                    libteamdctl - Teamd daemon control library.
libnl-cli-3.0                  libnl-cli - Command Line Interface library for netlink sockets
tinfo                          ncursesw - ncurses 6.4 library
libmnl                         libmnl - Minimalistic Netlink communication library
gmpxx                          GNU MP C++ - GNU Multiple Precision Arithmetic Library (C++ bindings)
libevent_core                  libevent_core - libevent_core
libxcrypt                      libxcrypt - Extended crypt library for DES, MD5, Blowfish and others
libiptc                        libiptc - iptables v4/v6 ruleset ADT and kernel interface
guile-3.0                      GNU Guile - GNU's Ubiquitous Intelligent Language for Extension
libevent                       libevent - libevent is an asynchronous notification event loop library
gmodule-2.0                    GModule - Dynamic module loader for GLib
libnl-route-3.0                libnl-route - Netlink Routing Family Library
pwquality                      pwquality - Password quality checker
sysprof-capture-4              sysprof-capture-4 - The static capture library for tools that generate profiling capture data
libcap                         libcap - libcap - linux capabilities library
python3-embed                  Python - Embed Python into an application
numa                           numa - NUMA policy library
libpsx                         libpsx - libpsx - linux posix syscall API for pthreads
com_err                        com_err - Common error description library
libpcre2-32                    libpcre2-32 - PCRE2 - Perl compatible regular expressions C library (2nd API) with 32 bit character support
libbpf                         libbpf - BPF library
libassuan                      libassuan - IPC library for the GnuPG components
liblz4                         lz4 - extremely fast lossless compression algorithm library
libnl-nf-3.0                   libnl-nf - Netfilter Netlink Library
libcap-ng                      libcap-ng - An alternate POSIX capabilities library.
lber                           lber (OpenLDAP) - OpenLDAP Lightweight ASN.1 Basic Encoding Rules library
ksba                           ksba - X.509 and CMS support library
ncurses++w                     ncurses++w - ncurses 6.4 add-on library
expat                          expat - expat XML parser
liburing-ffi                   liburing - io_uring FFI library
nspr                           NSPR - The Netscape Portable Runtime
libnfnetlink                   libnfnetlink - Low-level netfilter netlink communication library
hogweed                        Hogweed - Nettle low-level cryptographic library (public-key algorithms)
libnl-genl-3.0                 libnl-genl - Generic Netlink Library
libparted-fs-resize            libparted-fs-resize - The GNU Parted filesystem resize shared library
libnfsidmap                    libnfsidmap - Library that handles mapping between names and ids for NFSv4.
dbus-1                         dbus - Free desktop message bus
libargon2                      libargon2 - Development libraries for libargon2
ModemManager                   ModemManager - Common headers provided by ModemManager
libusb-1.0                     libusb-1.0 - C API for USB device access from Linux, Mac OS X, Windows, OpenBSD/NetBSD and Solaris userspace
tcl                            Tool Command Language - Tcl is a powerful, easy-to-learn dynamic programming language, suitable for a wide range of uses.
libnghttp2                     libnghttp2 - HTTP/2 C library
icu-io                         icu-io - International Components for Unicode: Stream and I/O Library
formw                          formw - ncurses 6.4 add-on library
mit-krb5                       mit-krb5 - An implementation of Kerberos network authentication
libcurl                        libcurl - Library to transfer files with ftp, http, etc.
polkit-agent-1                 polkit-agent-1 - PolicyKit Authentication Agent API
libpcre32                      libpcre32 - PCRE - Perl compatible regular expressions C library with 32 bit character support
tss2-sys                       tss2-sys - TPM2 System API library.
libverto                       libverto - Event loop abstraction interface
mozilla-nspr                   NSPR - The Netscape Portable Runtime
path_utils                     path_utils - Utility functions to manipulate filesystem pathnames
libssl                         OpenSSL-libssl - Secure Sockets Layer and cryptography libraries
libpcsclite                    PCSC Lite - PC/SC smart card interface
tss2-tcti-swtpm                tss2-tcti-swtpm - TCTI library for communicating with swtpm.
tss2-esys                      tss2-esys - TPM2 Enhanced System API library.
gpgme-glib                     gpgme-glib - GnuPG Made Easy to access GnuPG with Glib
mount                          mount - mount library
libevent_pthreads              libevent_pthreads - libevent_pthreads adds pthreads-based threading support to libevent
libnl-xfrm-3.0                 libnl-xfrm - Netlink Routing Family Library
libpcap                        libpcap - Platform-independent network traffic capture library
libipq                         libipq - Interface to the (old) ip_queue mechanism
smartcols                      smartcols - table or tree library
libpipeline                    libpipeline - Pipeline manipulation library
liblzma                        liblzma - General purpose data compression library
pam_misc                       pam_misc - Miscellaneous functions that make the job of writing PAM-aware applications easier.
form                           formw - ncurses 6.4 add-on library
menu                           menuw - ncurses 6.4 add-on library
libkmod                        libkmod - Library to deal with kernel modules
libudev                        libudev - Library to access udev device information
icu-i18n                       icu-i18n - International Components for Unicode: Internationalization library
polkit-gobject-1               polkit-gobject-1 - PolicyKit Authorization API
libcrypt                       libxcrypt - Extended crypt library for DES, MD5, Blowfish and others
mozilla-nss                    NSS - Network Security Services
tss2-mu                        tss2-mu - TPM2 type marshaling and unmarshaling library.
tic                            ncursesw - ncurses 6.4 library
libpcreposix                   libpcreposix - PCREPosix - Posix compatible interface to libpcre
openpgm-5.3                    OpenPGM - PGM Protocol Library.
collection                     collection - A data-type to collect data in a heirarchical structure for easy iteration and serialization
libsasl2                       Cyrus SASL - Cyrus SASL implementation
libnftnl                       libnftnl - Netfilter nf_tables infrastructure library
sqlite3                        SQLite - SQL database engine
gthread-2.0                    GThread - Thread support for GLib
fdisk                          fdisk - fdisk library
efisec                         efisec - UEFI Security Features
libpcrecpp                     libpcrecpp - PCRECPP - C++ wrapper for PCRE
mpfr                           mpfr - C library for multiple-precision floating-point computations
libteam                        libteam - Libteam library.
bzip2                          bzip2 - A file compression library
mm-glib                        mm-glib - Library to control and monitor the ModemManager
libkeyutils                    libkeyutils - keyutils library
mobile-broadband-provider-info mobile-broadband-provider-info - Mobile Broadband Service Provider Information Database
hwdata                         hwdata - Hardware identification and configuration data
libmakepkg                     libmakepkg - Arch Linux package build utility
udev                           udev - udev
systemd                        systemd - systemd System and Service Manager