glesv2                         GLESv2 - OpenGL ES v2/v3 library and headers.
python3-embed                  Python - Embed Python into an application
pthread-stubs                  pthread stubs - Meta package for pthread symbols - defaults to heavyweight ones if the C runtime does not provide lightweight ones.
x11                            X11 - X Library
egl                            EGL - EGL library and headers
xdmcp                          Xdmcp - X Display Manager Control Protocol library
python-3.11                    Python - Build a C extension for Python
xau                            Xau - X authorization file management libary
libtirpc                       libtirpc - Transport Independent RPC Library
libcrypt                       libxcrypt - Extended crypt library for DES, MD5, Blowfish and others
libnsl                         libnsl - Library containing NIS functions using TI-RPC (IPv6 enabled)
openblas                       openblas - OpenBLAS is an optimized BLAS library based on GotoBLAS2 1.13 BSD version
libxcrypt                      libxcrypt - Extended crypt library for DES, MD5, Blowfish and others
blas-netlib                    BLAS - FORTRAN reference implementation of BLAS Basic Linear Algebra Subprograms
python-3.11-embed              Python - Embed Python into an application
glx                            GLX - GLX library and headers.
opengl                         OpenGL - OpenGL (without GLX) library and headers.
libglvnd                       libglvnd - Vendor-neutral OpenGL dispatch library vendor interface
expat                          expat - expat XML parser
xcb                            XCB - X-protocol C Binding
blas                           openblas-blas - Optimized BLAS (linear algebra) library based on GotoBLAS2
python3                        Python - Build a C extension for Python
lapack-netlib                  LAPACK - FORTRAN reference implementation of LAPACK Linear Algebra PACKage
glesv1_cm                      GLESv1_CM - OpenGL ES-CM v1 library and headers.
gl                             GL - Legacy OpenGL and GLX library and headers.
zlib                           zlib - zlib compression library
lapack                         openblas-lapack - Optimized BLAS (linear algebra) library, LAPACK
resourceproto                  ResourceProto - Resource extension headers
xf86bigfontproto               XF86BigFontProto - XF86BigFont extension headers
dri2proto                      DRI2Proto - DRI2 extension headers
presentproto                   PresentProto - Present extension headers
xineramaproto                  XineramaProto - Xinerama extension headers
dri3proto                      DRI3Proto - DRI3 extension headers
dpmsproto                      DPMSProto - DPMS extension headers
dmxproto                       DMXProto - DMX extension headers
xkeyboard-config               XKeyboardConfig - X Keyboard configuration data
randrproto                     RandrProto - Randr extension headers
renderproto                    RenderProto - Render extension headers
xextproto                      XExtProto - XExt extension headers
xproto                         Xproto - Xproto headers
fixesproto                     FixesProto - X Fixes extension headers
xcmiscproto                    XCMiscProto - XCMisc extension headers
bash-completion                bash-completion - programmable completion for the bash shell
udev                           udev - udev
shared-mime-info               shared-mime-info - Freedesktop common MIME database
systemd                        systemd - systemd System and Service Manager
xf86dgaproto                   XF86DGAProto - XF86DGA extension headers
videoproto                     VideoProto - Video extension headers
iso-codes                      iso-codes - ISO country, language, script and currency codes and translations
xf86driproto                   XF86DRIProto - XF86DRI extension headers
recordproto                    RecordProto - Record extension headers
damageproto                    DamageProto - Damage extension headers
fontsproto                     FontsProto - Fonts extension headers
kbproto                        KBProto - KB extension headers
glproto                        GLProto - GL extension headers
xtrans                         XTrans - Abstract network code for X
xf86vidmodeproto               XF86VidModeProto - XF86VidMode extension headers
inputproto                     InputProto - Input extension headers
applewmproto                   AppleWMProto - AppleWM extension headers
scrnsaverproto                 ScrnSaverProto - ScrnSaver extension headers
compositeproto                 CompositeExt - Composite extension headers
xorg-sgml-doctools             xorg-sgml-doctools - Stylesheets and entities for X.Org documentation
bigreqsproto                   BigReqsProto - BigReqs extension headers